{
  "width": 10,
  "height": 8,
  "tile_types": {
    "0": "empty",
    "1": "ground", 
    "2": "wall",
    "3": "player",
    "4": "exit"
  },
  "tiles": [
    [2, 2, 2, 2, 2, 2, 2, 2, 2, 2],
    [2, 3, 1, 1, 1, 1, 1, 1, 1, 2],
    [2, 1, 1, 1, 1, 1, 1, 1, 1, 2],
    [2, 1, 1, 2, 2, 1, 1, 1, 1, 2],
    [2, 1, 1, 2, 2, 1, 1, 1, 1, 2],
    [2, 1, 1, 1, 1, 1, 1, 1, 1, 2],
    [2, 1, 1, 1, 1, 1, 1, 1, 4, 2],
    [2, 2, 2, 2, 2, 2, 2, 2, 2, 2]
  ]
}